~~~~~~~~~~~~~~~~~~~~~~~~~~~~~~.
~~~~~~~~~~~~~~~~~~~~~~~~~~~~~~.
~~~~........~~~~~~~~~~~~~~~~~~.
~~~~........~~~~~~~~~~~~~~~~~~.
~~~~........~~~~~~~~~~~~~~~~~~.
~~~~........~~~~~~~~~~~~~~~~~~.
~~~~........~~~~~~~~~~~~~~~~~~.
~~~~......................~~~~.
~~~~......................~~~~.
~~~~~~~~~~~~~~~~~~~~......~~~~.
~~~%%%%%%~~~~~~~~~~~......~~~~.
~~~%%%%%%~~~~~~~~~~~......~~~~.
~~~%%%%%%~~~~~~~~~~~......~~~~.
~~~~~~~~~~~~~~~~~~~~~~~~~~~~~~.
~~~~~~~~~~~~~~~~~~~~~~~~~~~~~~.

