~~~~~~~~~~~~~~~~~~~~~~~~~~~~~~.
~~~~~~~~~~~~~~~~~~~~~~~~~~~~~~.
.~~~........~~~~~~~~~~~~~~~~~~.
~~~~........~~~~~~~~~~~~~~~~~~.
~~~.........~~~~~~~~~~~~~~~~~~.
~~~~........~~~~~~~~~~~~~~~~~~.
.~~~........~~~~~~~~~~~~~~~~~~.
~~~~......................~~~~.
~~~.......................~~~~.
~~~~~~~~~~~~~~~~~~~~......~~~~.
.~~~~~~~~~~~~~~~~~~~......~~~~.
~~~~~~~~~~~~~~~~~~~~......~~~~.
~~~.~~~~~~~~~~~~~~~~......~~~~.
.~~~~~~~~~~~~~~~~~~~~~.~~~~~~~.
~~~~~~~~~o~~~~~~~~~~~~.~~~~~~~.
~~.~~~~~~....~~~~~~~~~~~~~~~~~.
~~.~~~~~~.~~~~~~~~~~~~.~~~~~~~.
~~.~~~~~~.~~~~~~~~~~~~.~~~~~~~.
...............................

