~~~~~~~~~~~~~~~~~~~~~~~~~~~~~~~~~~~~~~
~~~~~~~~~~~~~~~~~~~~~~~~~~~~~~~~~~~~~~
~~~~~~~~~~~~~~~~~~~~~~~~~~~~~~~~~~~~~~
~~~~~~~~~~~~~~~~~~~~~~~~~~~~~~~~~~~~~~
~~~~~~~~~~~~~~~~~~~~~~~~~~~~~~~~~~~~~~
~~~~~~~~~~~~~~~~~~~~~~~~~~~~~~~~~~~~~~
~~~~~~~~~~~~~~~~~~~~~~~~~~~~~~~~~~~~~~
~~~~~~~~~~~~~~~~~~~~~~~~~~~~~~~~~~~~~~
~~~~~~~~~~~~~~~~~~~~~~~~~~~~~~~~~~~~~~
~~~~~~~~~~~~~~~~~~~~~~~~~~~~~~~~~~~~~~
~~~~~~~~~~~~~~~~~~~~~~~~~~~~~~~~~~~~~~
~~~~~~~~~~~~~~~.~~~~~~~~~~~~~~~~~~~~~~
~~~~~~~~~~~~~~~.~~~~~~~~~~~~~~~~~~~~~~
~~~~~~~~~~~~~~~.~~~~~~~~~~~~~~~~~~~~~~
~~~~~~~~~~~o0~~~.~~~~~~~~~~~~~~~~~~~~~~
~~~~~~~~~.......~~~~~~~~~~~~~~~~~~~~~~
~~~~~~~~........~~~~~~~~~~~~~~~~~~~~~~
~~~~~~~.........~~~~~~~~~~~~~~~~~~~~~~
......................................
