~~~~~~~~~~~~~~~~~~~~~~~~~~~~~~.
~~~~~~~~~~~~~~~~~~~~~~~~~~~~~~.
.~~~........~~~~~~~~~~~~~~~~~~.
~~~~........~~~~~~~~~~~~~~~~~~.
~~~.........~~~~~~~~~~~~~~~~~~.
~~~~........~~~~~~~~~~~~~~~~~~.
.~~~........~~~~~~~~~~~~~~~~~~.
~~~~......................~~~~.
~~~.......................~~~~.
~~~~~~~~~~~~~~~~~~~~......~~~~.
.~~~%%%%%~~~~~~~~~~~......~~~~.
~~~~%%%%%~~~~~~~~~~~......~~~~.
~~~.%%%%%~~~~~~~~~~~......~~~~.
.~~~~~~~~~~~~~~~~~~~~~.~~~~~~~.
~~~~~~~~~~~~~~~~~~~~~~.~~~~~~~.
~~.~~~~~~....~~~~~~~~~.~~~~~~~.
~~.~~~~~~.~~~~~~~~~~~~.~~~~~~~.
~~.~~~~~~.~~~~~~~~~~~~.~~~~~~~.
...............................

